###############
#      @      #
#    b   b    #
# #         ###
#o#    b   h#a#
#o#h   b    #*#
#a#    b   h#a#
#*#h   b    #o#
#a#    b   h#o#
###h   b    # #
#             #
#     r     b #
#######o#######
#1     x     *#
###############
